       {2, 5, 5, 10, 10, 5, 10, 10, 10, 10, 10, 10, 10, 10, 10},
       {5, 0, 5, 10, 5, 10, 10, 10, 10, 10, 10, 10, 10, 10, 10},
       {5, 5, 0, 5, 5, 10, 10, 10, 5, 5, 10, 5, 10, 10, 10},
       {10, 10, 5, 0, 10, 10, 10, 10, 10, 10, 10, 5, 10, 10, 5},
       {10, 5, 5, 10, 0, 5, 10, 5, 10, 10, 10, 10, 10, 10, 10},
       {5, 10, 10, 10, 5, 0, 5, 5, 10, 10, 10, 10, 10, 10, 10},
       {10, 10, 10, 10, 10, 5, 0, 10, 10, 10, 5, 10, 10, 10, 10},
       {10, 10, 10, 10, 5, 5, 10, 0, 5, 5, 5, 10, 10, 10, 10},
       {10, 10, 5, 10, 10, 10, 10, 5, 0, 5, 10, 5, 10, 5, 10},
       {10, 10, 5, 10, 10, 10, 10, 5, 5, 0, 10, 5, 5, 10, 10},
       {10, 10, 10, 10, 10, 10, 5, 5, 10, 10, 0, 10, 10, 5, 10},
       {10, 10, 5, 5, 10, 10, 10, 10, 5, 5, 10, 0, 10, 10, 10},
       {10, 10, 10, 10, 10, 10, 10, 10, 10, 5, 10, 10, 8, 5, 5},
       {10, 10, 10, 10, 10, 10, 10, 10, 5, 10, 5, 10, 5, 0, 5},
       {10, 10, 10, 5, 10, 10, 10, 10, 10, 10, 10, 10, 5, 5, 0},
